0, 0, 0, 0, 0, 0, 15, 0, 0, 0, 0, 0, 0, 0, 0, 0, 0, 0, 0, 0,
0, 4, 4, 4, 4, 4, 2, 4, 4, 4, 4, 4, 4, 4, 4, 4, 4, 4, 4, 0,		
0, 4, 1, 1, 1, 1, 7, 1, 1, 1, 1, 1, 1, 1, 1, 1, 1, 1, 4, 0,		
0, 4, 1, 1, 1, 1, 7, 1, 1, 1, 1, 1, 1, 1, 1, 1, 1, 1, 4, 0,		
0, 4, 1, 1, 0, 0, 5, 0, 0, 0, 5, 5, 0, 0, 0, 0, 0, 1, 4, 0,		
0, 4, 1, 1, 0, 0, 5, 0, 0, 0, 5, 5, 0, 0, 0, 0, 0, 1, 4, 0,		
0, 4, 1, 1, 0, 0, 5, 0, 0, 0, 5, 0, 0, 0, 5, 0, 0, 1, 4, 0,		
0, 4, 1, 1, 0, 0, 5, 0, 0, 0, 5, 0, 0, 0, 5, 0, 0, 1, 4, 0,		
0, 4, 1, 1, 0, 0, 2, 5, 5, 5, 5, 0, 0, 8, 5, 0, 0, 1, 4, 0,		
2, 2, 1, 1, 0, 0, 2, 2, 2, 5, 2, 2, 0, 9, 5, 0, 0, 1, 4, 0,		
0, 4, 1, 1, 0, 0, 0, 0, 0, 0, 0, 2, 0, 0, 5, 0, 0, 1, 4, 0,		
0, 4, 1, 1, 0, 0, 0, 0, 0, 0, 0, 2, 0, 0, 5, 0, 0, 1, 4, 0,		
0, 4, 1, 1, 0, 0, 0, 0, 2, 2, 2, 2, 0, 0, 5, 0, 0, 1, 4, 0,		
0, 4, 1, 1, 0, 0, 0, 0, 0, 0, 0, 0, 0, 0, 0, 0, 0, 1, 4, 0,		
0, 4, 1, 1, 0, 0, 0, 0, 0, 0, 0, 0, 0, 0, 0, 0, 0, 1, 4, 0,		
0, 4, 1, 1, 0, 0, 0, 0, 0, 0, 0, 0, 0, 0, 0, 0, 0, 1, 4, 0,		
0, 4, 1, 1, 1, 1, 1, 1, 1, 1, 1, 1, 1, 1, 1, 1, 1, 1, 4, 0,		
0, 4, 1, 1, 1, 1, 1, 1, 1, 1, 1, 1, 1, 1, 1, 1, 1, 1, 4, 0,		
0, 4, 4, 4, 4, 4, 4, 4, 4, 4, 4, 4, 4, 4, 4, 4, 4, 4, 4, 0,		
0, 0, 0, 0, 0, 0, 0, 0, 0, 0, 0, 0, 0, 0, 0, 0, 0, 0, 0, 0,

0, 1, 1, 1, 1, 1, 9, 1, 1, 1, 1, 1, 1, 1, 1, 1, 1, 1, 1, 0,		
1, 9, 9, 9, 9, 9, 9, 9, 9, 9, 9, 9, 9, 9, 9, 9, 9, 9, 9, 1,		
0, 9, 5, 5, 5, 5, 7, 5, 5, 5, 5, 5, 5, 5, 5, 5, 5, 5, 9, 0,		
1, 9, 5, 5, 5, 5, 7, 5, 5, 5, 5, 5, 5, 5, 5, 5, 5, 5, 9, 1,		
0, 9, 5, 5, 5, 5, 9, 5, 5, 9, 9, 9, 9, 9, 9, 9, 5, 5, 9, 0,		
1, 9, 5, 5, 5, 5, 9, 5, 5, 5, 5, 5, 5, 6, 9, 9, 5, 5, 9, 1,		
0, 9, 5, 5, 5, 5, 9, 5, 5, 5, 5, 5, 5, 5, 5, 9, 5, 5, 9, 0,		
1, 9, 5, 5, 5, 5, 9, 5, 5, 5, 5, 5, 5, 5, 5, 5, 5, 5, 9, 1,		
9, 9, 5, 5, 5, 9, 9, 9, 9, 9, 9, 8, 8, 9, 8, 8, 8, 8, 9, 0,		
9, 9, 5, 5, 5, 9, 9, 9, 9, 9, 9, 9, 5, 5, 5, 5, 5, 5, 9, 1,		
0, 9, 5, 5, 5, 0, 9, 9, 9, 9, 9, 9, 5, 5, 5, 5, 5, 5, 9, 0,		
1, 9, 5, 5, 5, 1, 9, 9, 2, 2, 3, 9, 5, 5, 5, 5, 5, 5, 9, 1,		
0, 9, 5, 5, 5, 0, 0, 0, 0, 0, 0, 0, 5, 5, 5, 5, 5, 5, 9, 0,		
1, 9, 5, 5, 5, 1, 1, 1, 1, 1, 1, 1, 5, 5, 5, 5, 5, 5, 9, 1,		
0, 9, 5, 5, 5, 5, 5, 5, 6, 5, 9, 9, 9, 9, 9, 9, 5, 5, 9, 0,		
1, 9, 5, 5, 9, 9, 9, 9, 9, 9, 9, 9, 9, 9, 9, 9, 5, 5, 9, 1,		
0, 9, 5, 5, 5, 5, 5, 5, 5, 5, 5, 5, 5, 5, 5, 5, 5, 5, 9, 0,		
1, 9, 5, 5, 5, 5, 5, 5, 5, 5, 5, 5, 5, 5, 5, 5, 5, 5, 9, 1,		
0, 9, 9, 9, 9, 9, 9, 9, 9, 9, 9, 9, 9, 9, 9, 9, 9, 9, 9, 0,		
1, 9, 9, 9, 9, 9, 9, 9, 9, 9, 9, 9, 9, 9, 9, 9, 9, 9, 9, 1,

1, 1, 1, 1, 1, 1, 1, 1, 1, 1, 1, 1, 1, 1, 1, 1, 1, 1, 1, 1,		
1, 1, 1, 1, 1, 1, 1, 1, 1, 1, 1, 1, 1, 1, 1, 1, 1, 1, 1, 1,		
1, 1, 1, 1, 1, 1, 1, 1, 1, 1, 1, 1, 1, 1, 1, 1, 1, 1, 1, 1,		
1, 1, 1, 1, 1, 1, 1, 1, 1, 1, 1, 1, 1, 1, 1, 1, 1, 1, 1, 1,		
1, 1, 1, 1, 1, 1, 1, 1, 1, 1, 1, 1, 1, 1, 1, 1, 2, 1, 1, 1,		
1, 1, 1, 1, 1, 1, 1, 1, 1, 1, 1, 1, 1, 1, 1, 1, 1, 1, 1, 1,		
1, 1, 1, 1, 1, 1, 1, 1, 1, 1, 1, 1, 1, 1, 1, 1, 1, 1, 1, 1,		
1, 1, 1, 1, 1, 1, 1, 1, 1, 1, 1, 1, 1, 1, 1, 1, 1, 1, 1, 1,		
1, 1, 1, 1, 1, 1, 1, 1, 1, 1, 1, 1, 1, 1, 1, 1, 1, 1, 1, 1,		
1, 1, 1, 1, 1, 1, 1, 1, 1, 1, 1, 1, 1, 1, 1, 1, 1, 1, 1, 1,		
1, 1, 1, 1, 1, 1, 1, 1, 1, 1, 1, 1, 1, 1, 1, 1, 1, 1, 1, 1,		
1, 1, 1, 1, 1, 1, 1, 1, 1, 1, 1, 1, 1, 1, 1, 1, 1, 1, 1, 1,		
1, 1, 1, 1, 1, 1, 1, 1, 1, 1, 1, 1, 1, 1, 1, 1, 1, 1, 1, 1,		
1, 1, 1, 1, 1, 1, 1, 1, 1, 1, 1, 1, 1, 1, 1, 1, 1, 1, 1, 1,		
1, 1, 1, 1, 1, 1, 1, 1, 1, 1, 1, 1, 1, 1, 1, 1, 1, 1, 1, 1,		
1, 1, 1, 1, 1, 1, 1, 1, 1, 1, 1, 1, 1, 1, 1, 1, 1, 1, 1, 1,		
1, 1, 1, 1, 1, 1, 1, 1, 1, 1, 1, 1, 1, 1, 1, 1, 1, 1, 1, 1,		
1, 1, 1, 1, 1, 1, 1, 1, 1, 1, 1, 1, 1, 1, 1, 1, 1, 1, 1, 1,		
1, 1, 1, 1, 1, 1, 1, 1, 1, 1, 1, 1, 1, 1, 1, 1, 1, 1, 1, 1,		
1, 1, 1, 1, 1, 1, 1, 1, 1, 1, 1, 1, 1, 1, 1, 1, 1, 1, 1, 2